╻┏┓┏╸╺┳┓
┃╹┗╋┓╻┃┃
┣┓╻┃╹┃┃┃
╹┃┣╋┳┫╹┃
┗╋┛╹╹┣┳┛
╺━┓━━┓┣╸
╸╸╻╻┃┣┻╸
┏┃┃━━┻━╸